task4
An Interactive Fiction by Jason Antalis 19141859
Release 1 / Serial number 220805 / Inform 7 build 6M62 (I6/v6.33 lib 6/12N) SD

room A
You can see Greek box (closed) and Italian box (closed) here.

>yes
That was a rhetorical question.

>s
You can't go that way.

>cry
That's not a verb I recognise.

* * *

task4
An Interactive Fiction by Jason Antalis 19141859
Release 1 / Serial number 220805 / Inform 7 build 6M62 (I6/v6.33 lib 6/12N) SD

room A
You can see Greek box (closed) and Italian box (closed) here.

>Go into the Chest
You can't see any such thing.

>Change Rooms
That's not a verb I recognise.

>change room
That's not a verb I recognise.

* * *

task4
An Interactive Fiction by Jason Antalis 19141859
Release 1 / Serial number 220805 / Inform 7 build 6M62 (I6/v6.33 lib 6/12N) SD

room A
You can see Greek box (closed) and Italian box (closed) here.

>look
room A
Cast aside, as if worthless, is a plain brass ring.

You can also see two boxes, a Greek box and an Italian box here.

>look at boxes
You see nothing special about two boxes.

>showme
room A - room
    yourself - person
    two boxes
    Greek box
    Italian box
    plain ring

>look
room A
Cast aside, as if worthless, is a plain brass ring.

You can also see two boxes, a Greek box and an Italian box here.

>showme
room A - room
    yourself - person
    two boxes
    Greek box
    Italian box
    plain ring

* * *

task4
An Interactive Fiction by Jason Antalis 19141859
Release 1 / Serial number 220805 / Inform 7 build 6M62 (I6/v6.33 lib 6/12N) SD

room A
You can see Greek box (closed) and Italian box (closed) here.

>go south
room B
You can see an aquarium (in which is Paul the Octopus) here.

>go north
room A
You can see Greek box (closed) and Italian box (closed) here.

>look
room A
You can see Greek box (closed) and Italian box (closed) here.

>look at Greek box
This box has a Greek flag.

>carry Greek box
Taken.

>carry Italian box
You're carrying too many things already.

>look
room A
You can see Italian box (closed) here.

>go south
room B
You can see an aquarium (in which is Paul the Octopus) here.

>drop Greek box
Dropped.

>look
room B
You can see Greek box (closed) and an aquarium (in which is Paul the Octopus) here.

>pick up Greek box
Taken.

>drop Greek box into aquarium
You put Greek box into the aquarium.

>look
room B
You can see an aquarium (in which are Greek box (closed) and Paul the Octopus) here.

>pick up Greek box
Taken.

>look
room B
You can see an aquarium (in which is Paul the Octopus) here.

>inventory
You are carrying:
  Greek box

>drop
(Greek box)
Dropped.

>go back
You can't see any such thing.

>go north
room A
You can see Italian box (closed) here.

>pick up
(Italian box)
Taken.

>go south
room B
You can see Greek box (closed) and an aquarium (in which is Paul the Octopus) here.

>drop
(Italian box)
Dropped.

>pick up Italian box
Taken.

>drop Italian box into aquarium
You put Italian box into the aquarium.

>look
room B
You can see Greek box (closed) and an aquarium (in which are Italian box (closed) and Paul the Octopus) here.

>showme
room B - room
    yourself - person
    Greek box - closed container
        *Spartan Helmet
    aquarium - open container
        Italian box - closed container
            *Gladiator Sword
        Paul the Octopus
* denotes things which are not in scope

>pick up aquarium
That's fixed in place.

>drop
What do you want to drop?

>look
room B
You can see Greek box (closed) and an aquarium (in which are Italian box (closed) and Paul the Octopus) here.

>open Greek
It isn't something you can open.

* * *

task4
An Interactive Fiction by Jason Antalis 19141859
Release 1 / Serial number 220805 / Inform 7 build 6M62 (I6/v6.33 lib 6/12N) SD

room A
You can see Greek box (closed) and Italian box (closed) here.

>look at Greek box
This box has a Greek flag.

>look at Italian box
This box has a Italian flag.

>pick up Greek
Taken.

>drop
(Greek box)
Dropped.

>pick greek
I didn't understand that sentence.

>pick up greek box
Taken.

>go south
room B
You can see an aquarium (in which is Paul the Octopus) here.

>drop greek box in aquarium
You put Greek box into the aquarium.

>pick up greek
The Greek box has been placed into the aquarium, and cannot be removed.

That's fixed in place.

>pick up greek
The Greek box has been placed into the aquarium, and cannot be removed.

That's fixed in place.

>inventory
You are carrying nothing.

>look
room B
You can see an aquarium (in which are Greek box (closed) and Paul the Octopus) here.

>go north
room A
You can see Italian box (closed) here.

* * *

>pick up
(Italian box)
Taken.

>go south
room B
You can see an aquarium (in which are Greek box (closed) and Paul the Octopus) here.

>drop italian in aquarium
You put Italian box into the aquarium.

Which box will you open?

 The Greek box or the Italian box?

>look
look

room B
You can see an aquarium (in which are Italian box (closed), Greek box (closed) and Paul the Octopus) here.

>look
look

room B
You can see an aquarium (in which are Italian box (closed), Greek box (closed) and Paul the Octopus) here.

>go inside
go inside

You can't go that way.

>tell Dave box A
tell Dave box A

You can't see any such thing.

>tell Paul greek box
tell Paul greek box

I didn't understand that sentence.

>open greek
open greek

It isn't something you can open.

>yes
yes

That was a rhetorical question.

>look
look

room B
You can see an aquarium (in which are Italian box (closed), Greek box (closed) and Paul the Octopus) here.

>tell Paul cheese
tell Paul cheese

I didn't understand that sentence.

>tell Paul the Octopus cheese
tell Paul the Octopus cheese

I didn't understand that sentence.

>tell Paul the Octopus Greek box
tell Paul the Octopus Greek box

I didn't understand that sentence.

>tell Paul the Octopus to open Greek box
tell Paul the Octopus to open Greek box

I didn't understand that sentence.

>answer Paul greek
answer Paul greek

(to Paul the Octopus)
There is no reply.